#################################
#                               #
#                               #
#                               #
#                               #
#                               #
#                               #
#                               #
#       #               #       #
#       #               #       #
#       #               #       #
#       #               #       #
#       #               #       #
#       #               #       #
#       #               #       #
#       #               #       #
#       #               #       #
#       #               #       #
#       #               #       #
#       #               #       #
#       #               #       #
#       #               #       #
#       #               #       #
#       #               #       #
#       #               #       #
#                               #
#                               #
#                               #
#                               #
#                               #
#                               #
#                               #
#################################
