#################################
#                               #
#                               #
#                               #
#                               #
#    #  #     ##############    #
#    #  #                  #    #
#    #  #                  #    #
#    #  #     ###########  #    #
#    #  #               #  #    #
#    #  #               #  #    #
#    #  #               #  #    #
#    #  #               #  #    #
#    #  #               #  #    #
#    #  #               #  #    #
#    #  #      # #      #  #    #
#    #  #               #  #    #
#    #  #      # #      #  #    #
#    #  #               #  #    #
#    #  #               #  #    #
#    #  #               #  #    #
#    #  #               #  #    #
#    #  #               #  #    #
#    #  #               #  #    #
#    #  ###########     #  #    #
#    #                  #  #    #
#    #                  #  #    #
#    ##############     #  #    #
#                               #
#                               #
#                               #
#                               #
#################################
