#################################
#                               #
#                               #
#                               #
#                               #
#     #  #  #       #  #  #     #
#     #  #  #       #  #  #     #
#     #  #  #       #  #  #     #
#     #  #  #       #  #  #     #
#     #  #  #       #  #  #     #
#     #  #  #       #  #  #     #
#     #  #  #       #  #  #     #
#     #  #  #       #  #  #     #
#     #  #  #       #  #  #     #
#     #  #  #       #  #  #     #
#     #  #  #       #  #  #     #
#     #  #  #       #  #  #     #
#     #  #  #       #  #  #     #
#     #  #  #       #  #  #     #
#     #  #  #       #  #  #     #
#     #  #  #       #  #  #     #
#     #  #  #       #  #  #     #
#     #  #  #       #  #  #     #
#     #  #  #       #  #  #     #
#     #  #  #       #  #  #     #
#     #  #  #       #  #  #     #
#     #  #  #       #  #  #     #
#     #  #  #       #  #  #     #
#                               #
#                               #
#                               #
#                               #
#################################
