#################################
#                               #
#                               #
#                               #
#   #########################   #
#                               #
#                               #
#                               #
#   ###########   ###########   #
#             #   #             #
#             #   #             #
#             #   #             #
#   #######   #   #   #######   #
#         #   #   #   #         #
#         #   #   #   #         #
#         #   #   #   #         #
#         #   #   #   #         #
#         #   #   #   #         #
#         #   #   #   #         #
#         #   #   #   #         #
#         #   #   #   #         #
#         #   #   #   #         #
#         #   #   #   #         #
#         #   #   #   #         #
#         #   #   #   #         #
#         #   #   #   #         #
#         #   #   #   #         #
#         #   #   #   #         #
#         #   #   #   #         #
#                               #
#                               #
#                               #
#################################
