#################################
#                               #
#                               #
#                               #
#   #########################   #
#                               #
#                               #
#                               #
#   #########################   #
#                               #
#                               #
#                               #
#   #   #               #   #   #
#   #   #               #   #   #
#   #   #               #   #   #
#   # # #               # # #   #
#   # # #               # # #   #
#   # # #               # # #   #
#   # # #               # # #   #
#   # # #               # # #   #
#   # # #               # # #   #
#   # # #               # # #   #
#   # # #               # # #   #
#   # # #               # # #   #
#   # # #               # # #   #
#   # # #               # # #   #
#   # # #               # # #   #
#   # # #               # # #   #
#   # # #               # # #   #
#   #   #               #   #   #
#   # # #               # # #   #
#   #   #               #   #   #
#################################
