#################################
#                               #
#                               #
#                               #
#   ###########   ###########   #
#   #                       #   #
#   #                       #   #
#   #                       #   #
#   #   #######   #######   #   #
#   #   #               #   #   #
#   #   #               #   #   #
#   #   #               #   #   #
#   #   #   #########   #   #   #
#   #   #   #       #   #   #   #
#   #   #   #       #   #   #   #
#   #   #               #   #   #
#   #   #               #   #   #
#   #   #               #   #   #
#   #   #   #       #   #   #   #
#   #   #   #       #   #   #   #
#   #   #   #########   #   #   #
#   #   #               #   #   #
#   #   #               #   #   #
#   #   #               #   #   #
#   #   #######   #######   #   #
#   #                       #   #
#   #                       #   #
#   #                       #   #
#   ###########   ###########   #
#                               #
#                               #
#                               #
#################################
