#################################
#                               #
#                               #
#                               #
#   #   #   #################   #
#   #   #                   #   #
#   #   #                   #   #
#   #   #                   #   #
#   #   #   #############   #   #
#   #   #               #   #   #
#   #   #               #   #   #
#   #   #               #   #   #
#   #   #               #   #   #
#   #   #    ### ###    #   #   #
#   #   #    ### ###    #   #   #
#   #   #    ##   ##    #   #   #
#   #   #       #       #   #   #
#   #   #    ##   ##    #   #   #
#   #   #    ### ###    #   #   #
#   #   #    ### ###    #   #   #
#   #   #               #   #   #
#   #   #               #   #   #
#   #   #               #   #   #
#   #   #               #   #   #
#   #   #############   #   #   #
#   #                   #   #   #
#   #                   #   #   #
#   #                   #   #   #
#   #################   #   #   #
#                               #
#                               #
#                               #
#################################
