#################################
#                               #
#                               #
#                               #
#                               #
#  #  #  #  #       #  #  #  #  #
#  #  #  #  #       #  #  #  #  #
#  #  #  #  #       #  #  #  #  #
#  #  #  #  #       #  #  #  #  #
#  #  #  #  #       #  #  #  #  #
#  #  #  #  #       #  #  #  #  #
#  #  #  #  #       #  #  #  #  #
#  #  #  #  #       #  #  #  #  #
#  #  #  #  #       #  #  #  #  #
#  #  #  #  #       #  #  #  #  #
#  #  #  #  #       #  #  #  #  #
#  #  #  #  #       #  #  #  #  #
#  #  #  #  #       #  #  #  #  #
#  #  #  #  #       #  #  #  #  #
#  #  #  #  #       #  #  #  #  #
#  #  #  #  #       #  #  #  #  #
#  #  #  #  #       #  #  #  #  #
#  #  #  #  #       #  #  #  #  #
#  #  #  #  #       #  #  #  #  #
#  #  #  #  #       #  #  #  #  #
#  #  #  #  #       #  #  #  #  #
#  #  #  #  #       #  #  #  #  #
#  #  #  #  #       #  #  #  #  #
#                               #
#                               #
#                               #
#                               #
#################################
