#################################
#                               #
#                               #
#                               #
#   #########################   #
#                               #
#                               #
#                               #
#   #########################   #
#                               #
#                               #
#                               #
#   #   #   #########   #   #   #
#   #   #               #   #   #
#   #   #               #   #   #
# # # # #               # # # # #
# # # # #   #########   # # # # #
# # # # #               # # # # #
# # # # #               # # # # #
# # # # #               # # # # #
# # # # #   #########   # # # # #
# # # # #               # # # # #
# # # # #               # # # # #
# # # # #               # # # # #
# # # # #   #########   # # # # #
# # # # #               # # # # #
# # # # #               # # # # #
# # # # #               # # # # #
# # # # #               # # # # #
#   #   #               #   #   #
# # # # #               # # # # #
#   #   #               #   #   #
#################################
