#################################
#                               #
#                               #
#                               #
#   ###########   ###########   #
#   #                       #   #
#   #                       #   #
#   #                       #   #
#   #   #################   #   #
#   #   #               #   #   #
#   #   #               #   #   #
#   #   #               #   #   #
#   #   #   ###   ###   #   #   #
#   #   #   #       #   #   #   #
#   #   #   #   #   #   #   #   #
#   #       #       #       #   #
#   #       # #   # #       #   #
#   #       #       #       #   #
#   #   #   #   #   #   #   #   #
#   #   #   #       #   #   #   #
#   #   #   ###   ###   #   #   #
#   #   #               #   #   #
#   #   #               #   #   #
#   #   #               #   #   #
#   #   #################   #   #
#   #                       #   #
#   #                       #   #
#   #                       #   #
#   ###########   ###########   #
#                               #
#                               #
#                               #
#################################
