#################################
#                               #
#                               #
#                               #
#                               #
#                               #
#                               #
#                               #
#      ###################      #
#               #               #
#               #               #
#               #               #
#               #               #
#               #               #
#               #               #
#               #               #
#               #               #
#               #               #
#               #               #
#               #               #
#               #               #
#               #               #
#               #               #
#               #               #
#               #               #
#                               #
#                               #
#                               #
#                               #
#                               #
#                               #
#                               #
#################################
