#################################
#                               #
#       #                       #
#       #                       #
#   #   #   #################   #
#   #   #                   #   #
#   #   #                   #   #
#   #   #                   #   #
#   #   #   #############   #   #
#   #   #               #   #   #
#   #   #               #   #   #
#   #   #               #   #   #
#   #   #               #   #   #
#   #   #    ### # #    #   #   #
#   #   #        # #    #   #   #
#   #   #    ##    #    #   #   #
#   #   #       #       #   #   #
#   #   #    #    ##    #   #   #
#   #   #    # #        #   #   #
#   #   #    # # ###    #   #   #
#   #   #               #   #   #
#   #   #               #   #   #
#   #   #               #   #   #
#   #   #               #   #   #
#   #   #############   #   #   #
#   #                   #   #   #
#   #                   #   #   #
#   #                   #   #   #
#   #################   #   #   #
#                       #       #
#                       #       #
#                               #
#################################
