#################################
#                               #
#                               #
#                               #
#   #   #   #   #   #   #   #   #
#   #   #   #   #   #   #   #   #
#   #   #   #   #   #   #   #   #
#   #   #   #   #   #   #   #   #
#   #   #   #   #   #   #   #   #
#   #   #   #   #   #   #   #   #
#   #   #   #   #   #   #   #   #
#   #   #   #   #   #   #   #   #
#   #   #   #   #   #   #   #   #
#   #   #   #   #   #   #   #   #
#   #   #   #   #   #   #   #   #
#   #   #   #   #   #   #   #   #
#   #   #   #   #   #   #   #   #
#   #   #   #   #   #   #   #   #
#   #   #   #   #   #   #   #   #
#   #   #   #   #   #   #   #   #
#   #   #   #   #   #   #   #   #
#   #   #   #   #   #   #   #   #
#   #   #   #   #   #   #   #   #
#   #   #   #   #   #   #   #   #
#   #   #   #   #   #   #   #   #
#   #   #   #   #   #   #   #   #
#   #   #   #   #   #   #   #   #
#   #   #   #   #   #   #   #   #
#   #   #   #   #   #   #   #   #
#                               #
#                               #
#                               #
#################################
