#################################
#                               #
#                               #
#                               #
#   #########################   #
#                               #
#                               #
#                               #
###############   ###############
#             #   #             #
#             #   #             #
#             #   #             #
#   #######   #   #   #######   #
#         #   #   #   #         #
#         #   #   #   #         #
#         #   #   #   #         #
#  ####   #   #   #   #   ####  #
#     #   #   #   #   #   #     #
#     #   #   #   #   #   #     #
#     #   #   #   #   #   #     #
#     #   #   #   #   #   #     #
#     #   #   #   #   #   #     #
#     #   #   #   #   #   #     #
#     #   #   #   #   #   #     #
#     #   #   #   #   #   #     #
#     #   #   #   #   #   #     #
#     #   #   #   #   #   #     #
#     #   #   #   #   #   #     #
#     #   #   #   #   #   #     #
#     #       #   #       #     #
#     #                   #     #
#     #                   #     #
#################################
