#################################
#                               #
#                               #
#                               #
#   #########################   #
#                               #
#      ###################      #
#                               #
#   #########################   #
#                               #
#               #               #
#                               #
#   #   #   # ##### #   #   #   #
#   #   #   #       #   #   #   #
#   #   #   #   #   #   #   #   #
# # # # # # #       # # # # # # #
# # # # # # # ##### # # # # # # #
# # # # # # #       # # # # # # #
# # # # # # #   #   # # # # # # #
# # # # # # #       # # # # # # #
# # # # # # # ##### # # # # # # #
#   #   #   #       #   #   #   #
# # # # # # #   #   # # # # # # #
# # # # # # #       # # # # # # #
# # # # # # # ##### # # # # # # #
# # # # # # #       # # # # # # #
# # # # # # #       # # # # # # #
# # # # # # #       # # # # # # #
# # # # # # #       # # # # # # #
#   #   #   #       #   #   #   #
#   #   #   #       #   #   #   #
#   #   #   #       #   #   #   #
#################################
