#################################
#                               #
#                               #
#                               #
#     #####################     #
#                               #
#   #                       #   #
#   #                       #   #
#   #     #############     #   #
#   #                       #   #
#   #   #               #   #   #
#   #   #               #   #   #
#   #   #     #####     #   #   #
#   #   #               #   #   #
#   #   #   #       #   #   #   #
#   #   #   #  # #  #   #   #   #
#   #   #   #       #   #   #   #
#   #   #   #  # #  #   #   #   #
#   #   #   #       #   #   #   #
#   #   #               #   #   #
#   #   #     #####     #   #   #
#   #   #               #   #   #
#   #   #               #   #   #
#   #                       #   #
#   #     #############     #   #
#   #                       #   #
#   #                       #   #
#                               #
#     ########## ##########     #
#                               #
#                               #
#                               #
#################################
