#################################
#                               #
#      #                        #
#      #                        #
#   #  # ####################   #
#   #  #                    #   #
#   #  #                    #   #
#   #  #   ###############  #   #
#   #  #                 #  #   #
#   #  #       ###       #  #   #
#   #  #                 #  #   #
#   #  #       ###       #  #   #
#   #  #                 #  #   #
#   #  #     # # # #     #  #   #
#   #  #       # #       #  #   #
#   #  # # # ##   ## # # #  #   #
#   #  # # #    #    # # #  #   #
#   #  # # # ##   ## # # #  #   #
#   #  #       # #       #  #   #
#   #  #     # # # #     #  #   #
#   #  #                 #  #   #
#   #  #       ###       #  #   #
#   #  #                 #  #   #
#   #  #       ###       #  #   #
#   #  #                 #  #   #
#   #  ###############   #  #   #
#   #                    #  #   #
#   #                    #  #   #
#   #################### #  #   #
#                        #      #
#                        #      #
#                               #
#################################
