#################################
#                               #
#                               #
#                               #
#                               #
#                               #
#                               #
#                               #
#      ################  #      #
#      #              #  #      #
#      #              #  #      #
#      #  #######     #  #      #
#      #  #     #     #  #      #
#      #  #     #     #  #      #
#      #  # # # #     #  #      #
#      #  #     #     #  #      #
#      #  #     #     #  #      #
#      #  #     #     #  #      #
#      #  #     # # # #  #      #
#      #  #     #     #  #      #
#      #  #     #     #  #      #
#      #  #     #######  #      #
#      #  #              #      #
#      #  #              #      #
#      #  ################      #
#                               #
#                               #
#                               #
#                               #
#                               #
#                               #
#                               #
#################################
