#################################
#                               #
#                               #
#  #                         #  #
#    ########### ###########    #
#   ##         # #         ##   #
#   #      ##       ##      #   #
#   #          # #          #   #
#   #          # #          #   #
#   #          # #          #   #
#   #          # #          #   #
#   # #    ##       ##    # #   #
#   # #    ##       ##    # #   #
#   #          # #          #   #
#   #         ## ##         #   #
#   ## ####  ##   ##  #### ##   #
#               #               #
#   ## ####  ##   ##  #### ##   #
#   #         ## ##         #   #
#   #          # #          #   #
#   # #    ##       ##    # #   #
#   # #    ##       ##    # #   #
#   #          # #          #   #
#   #          # #          #   #
#   #          # #          #   #
#   #          # #          #   #
#   #      ##       ##      #   #
#   ##         # #         ##   #
#    ########### ###########    #
#  #                         #  #
#                               #
#                               #
#################################
