#################################
#             #   #             #
# #           #   #           # #
#             #   #             #
#                           #   #
#             #   #             #
#             #   #       #     #
#             #   #     #       #
#             #   #             #
#          #  #   #   #         #
#         ##  #   #             #
#        ##  ##   # #           #
#       ##  ##    #             #
#      ##  ##     ########### ###
#         ##                    #
#        ##   ###               #
### ######   #######   ###### ###
#               ###   ##        #
#                    ##         #
### ###########     ##  ##      #
#             #    ##  ##       #
#           # #   ##  ##        #
#             #   #  ##         #
#         #   #   #  #          #
#             #   #             #
#       #     #   #             #
#     #       #   #             #
#             #   #             #
#   #                           #
#             #   #             #
# #           #   #           # #
#             #   #             #
#################################
