#################################
#                               #
# #            ###            # #
#                               #
#   ############ ############   #
#   #          # #          #   #
#   # #     ##     ##     # #   #
#   #          # #          #   #
#   #          # #          #   #
#   #          # #          #   #
#   #          # #          #   #
#   #          # #          #   #
#   # #     ##     ##     # #   #
#   # #     #  # #  #     # #   #
#   #         ## ##         #   #
# # ## ##### ##   ## ##### ## # #
# #             #             # #
# # ## ##### ##   ## ##### ## # #
#   #         ## ##         #   #
#   # #     #  # #  #     # #   #
#   # #     ##     ##     # #   #
#   #          # #          #   #
#   #          # #          #   #
#   #          # #          #   #
#   #          # #          #   #
#   #          # #          #   #
#   # #     ##     ##     # #   #
#   #          # #          #   #
#   ############ ############   #
#                               #
# #            # #            # #
#                               #
#################################
