#################################
#                               #
#                               #
#                               #
#                               #
#                               #
#                               #
#                               #
#       #################       #
#                               #
#                               #
#                               #
#                               #
#                               #
#                               #
#                               #
#       #               #       #
#       #               #       #
#       #               #       #
#       #               #       #
#       #               #       #
#       #               #       #
#       #               #       #
#       #               #       #
#       #               #       #
#       #               #       #
#       #               #       #
#       #               #       #
#       #               #       #
#       #               #       #
#       #               #       #
#       #               #       #
#################################
