#################################
#       ##    ##  ##            #
#   ##  ## ## ##  ##     ##     #
#   ##  ## ##     ##  ## ##     #
### ##                ##     ## #
###     ##   ## ##      ##   ## #
#       ##   ## ## ##   ##      #
# ##            ## ##        ## #
# ##    ## ##          ## ## ## #
#    ## ## ##    ##    ## ## ## #
#    ## ## ## ## ## ##          #
####    ## ## ## ## ##          #
####    ##    ## ##      #### ###
#          ## ##  ###    #### ###
#          ##     ###           #
#    ##### ## ##                #
#    #####    ##    ## ##  ## ###
####       ##       ## ##  ## ###
#### ###   ## ## ##        ##   #
#    ### ##   ## ## ##   ##     #
#        ##         ##   ##   ###
#   ###       ##         ##   ###
#   ### ## ## ##                #
##      ## ## ## ###  ###   ##  #
## ###  ##       ###  ###   ##  #
## ###       ###                #
##      ##   ### ##      ## ##  #
##  ### ##       ##  #   ## ## ##
##  ### ## ##        # ##      ##
#          ## #      # ##  ##  ##
#  ###        #  ##        ##   #
#  ###        #  ##             #
#################################
