#################################
#                               #
#                               #
#                               #
#                               #
#                               #
#                               #
#                               #
#       #####       #####       #
#       #               #       #
#       #               #       #
#       #               #       #
#       #               #       #
#       #               #       #
#       #               #       #
#       #               #       #
#       #               #       #
#       #               #       #
#       #               #       #
#       #               #       #
#       #               #       #
#       #               #       #
#       #               #       #
#       #               #       #
#       #####       #####       #
#                               #
#                               #
#                               #
#                               #
#                               #
#                               #
#                               #
#################################
