#################################
#                               #
#                               #
#                               #
#                               #
#                               #
#                               #
#                               #
#       #       #########       #
#       #               #       #
#       #               #       #
#       #               #       #
#       #               #       #
#       #               #       #
#       #               #       #
#       #               #       #
#       #       #       #       #
#       #               #       #
#       #               #       #
#       #               #       #
#       #               #       #
#       #               #       #
#       #               #       #
#       #               #       #
#       #########       #       #
#                               #
#                               #
#                               #
#                               #
#                               #
#                               #
#                               #
#################################
