#################################
#                               #
#                               #
#                               #
#                               #
#     #  #             #  #     #
#     #  #             #  #     #
#     #  #             #  #     #
#     #  #             #  #     #
#     #  #             #  #     #
#     #  #             #  #     #
#     #  #             #  #     #
#     #  #             #  #     #
#     #  #             #  #     #
#     #  #             #  #     #
#     #  #             #  #     #
#     #  #             #  #     #
#     #  #             #  #     #
#     #  #             #  #     #
#     #  #             #  #     #
#     #  #             #  #     #
#     #  #             #  #     #
#     #  #             #  #     #
#     #  #             #  #     #
#     #  #             #  #     #
#     #  #             #  #     #
#     #  #             #  #     #
#     #  #             #  #     #
#                               #
#                               #
#                               #
#                               #
#################################
