#################################
#                               #
#                               #
#                               #
#                               #
#    #######################    #
#                               #
#                               #
#    ##########   ##########    #
#             #   #             #
#             #   #             #
#             #   #             #
#             #   #             #
#             #   #             #
#             #   #             #
#             #   #             #
#             #   #             #
#             #   #             #
#             #   #             #
#             #   #             #
#             #   #             #
#             #   #             #
#             #   #             #
#             #   #             #
#             #   #             #
#             #   #             #
#             #   #             #
#             #   #             #
#                               #
#                               #
#                               #
#                               #
#################################
