#################################
#                               #
#                               #
#                               #
#                               #
#    #######################    #
#                               #
#                               #
#    #######################    #
#                               #
#                               #
#                               #
#    #  #               #  #    #
#    #  #               #  #    #
#    #  #               #  #    #
#    #  #               #  #    #
#    #  #               #  #    #
#    #  #               #  #    #
#    #  #               #  #    #
#    #  #               #  #    #
#    #  #               #  #    #
#    #  #               #  #    #
#    #  #               #  #    #
#    #  #               #  #    #
#    #  #               #  #    #
#    #  #               #  #    #
#    #  #               #  #    #
#    #  #               #  #    #
#    #  #               #  #    #
#    #  #               #  #    #
#    #  #               #  #    #
#    #  #               #  #    #
#################################
