#################################
#                               #
#                               #
#                               #
#                               #
#    #########     #########    #
#    #                     #    #
#    #                     #    #
#    #  ######     ######  #    #
#    #  #               #  #    #
#    #  #               #  #    #
#    #  #               #  #    #
#    #  #               #  #    #
#    #  #               #  #    #
#    #  #               #  #    #
#    #  #               #  #    #
#    #  #               #  #    #
#    #  #               #  #    #
#    #  #               #  #    #
#    #  #               #  #    #
#    #  #               #  #    #
#    #  #               #  #    #
#    #  #               #  #    #
#    #  #               #  #    #
#    #  ######     ######  #    #
#    #                     #    #
#    #                     #    #
#    #########     #########    #
#                               #
#                               #
#                               #
#                               #
#################################
